F F F F F F F F F F F F F F F F F F F F F F F F F F F F
X X X X X X X X X X X X X X X X X X X X X X X X X X X X
X N - - - - N - - - - - N X X N - - - - - N - - - - N X
X | X X X X | X X X X X | X X | X X X X X | X X X X | X
X P X X X X | X X X X X | X X | X X X X X | X X X X P X
X | X X X X | X X X X X | X X | X X X X X | X X X X | X
X N - - - - N - - N - - N - - N - - N - - N - - - - N X
X | X X X X | X X | X X X X X X X X | X X | X X X X | X
X | X X X X | X X | X X X X X X X X | X X | X X X X | X
X N - - - - N X X N - - N X X N - - N X X N - - - - N X
X X X X X X | X X X X X E X X E X X X X X | X X X X X X
F F F F F X | X X X X X E X X E X X X X X | X F F F F F
F F F F F X | X X n E E n b E n E E n X X | X F F F F F
F F F F F X | X X E X X S S S S X X E X X | X F F F F F
X X X X X X | X X E X E E E E E E X E X X | X X X X X X
E E E E E E N E E n X E E E E E E X n E E N E E E E E E
X X X X X X | X X E X c E i E p E X E X X | X X X X X X
F F F F F X | X X E X X X X X X X X E X X | X F F F F F
F F F F F X | X X n E E E E E E E E n X X | X F F F F F
F F F F F X | X X E X X X X X X X X E X X | X F F F F F
X X X X X X | X X E X X X X X X X X E X X | X X X X X X
X N - - - - N - - N - - N X X N - - N - - N - - - - N X
X | X X X X | X X X X X | X X | X X X X X | X X X X | X
X | X X X X | X X X X X | X X | X X X X X | X X X X | X
X P - N X X N - - N - - N E Y N - - N - - N X X N - P X
X X X | X X | X X | X X X X X X X X | X X | X X | X X X
X X X | X X | X X | X X X X X X X X | X X | X X | X X X
X N - N - - N X X N - - N X X N - - N X X N - - N - N X
X | X X X X X X X X X X | X X | X X X X X X X X X X | X
X | X X X X X X X X X X | X X | X X X X X X X X X X | X
X N - - - - - - - - - - N - - N - - - - - - - - - - N X
X X X X X X X X X X X X X X X X X X X X X X X X X X X X
F F F F F F F F F F F F F F F F F F F F F F F F F F F F
F F F F F F F F F F F F F F F F F F F F F F F F F F F F
F F F F F F F F F F F F F F F F F F F F F F F F F F F F
F F F F F F F F F F F F F F F F F F F F F F F F F F F F